NO ./stone12.xpm
SO ./stone2.xpm
WE ./stone3.xpm
EA ./stone4.xpm

F 240,211,117
C 84,171,179

        11111111111111                 11111111            11111111111111111  111111111111111
     1110000000000001                  10000001            100000000000000011 100000000000001
   110000000000000001                 10000001            1000000111110000011100000000000001111
  1000001111111100001                  1000001            1111111     10000011110000011111000001
 1000001       111111111111    111111  100000111111111                1000001  1000001    1000001
1000001              100001    100001  10000000000000011              1000001  1000001     1000001
1000001              100001    100001  100000000000000001     11111111000001   1000001     1000001
1000001              100001    100001  1001001111100000001    10000000000011    1000001     1000001
10000011             100001   1100011  1001001   110000001    11111111000001   1001001     1000001
1000001              100001   100001  10010011     1000001            1000001  1000001     1000001
1000001              100001    100001  1001001     1001001            1000001  1000001     1000001
 1000001       1111111000001111000001  1000001     1000001            1000001  1000001    1000001
  100000111111110000110000000000000001110000011111100000011111111    110000011110000011111000001
   110000000N0000000000000000000000001100010000000000000000000001111100000000000100000000000111
     111000 0000000001111100000000111011000000000000000111111000000000000001111101000000000111
        11111111111111   111111111  111111111111111111111   11111111111111111  11111111111111