NO ./stone12.xpm
SO ./stone2.xpm
WE ./stone3.xpm
EA ./stone4.xpm


F 240,211,117
C 84,171,179

111111111111111111111111111
11111111111111111111
100000010110000000001
10000001000001000001111111111111111111
10000001000001000000000000000000000001
10000001000001000001111111111111111101
10000001000001000001               101
10000001000001000001   0000000     101
10000001000001000001   0000000     101
10000001000001000001               101
10000001000001000001111111111111111101
10000001000001000000000000000000000001
10000001000001000001111111111111111111
1000N0000000010000011111111111
10000000100001000001 100000001
11111111111111111111111111111111