WE ./stone3.xpm
NO ./stone12.xpm
SO ./stone2.xpm
EA ./stone4.xpm

F 240,211,255
C 84,171,179

1111
1N001
1111